111111111111111
100001000000001
1C0000001000101
101011C00000011
10000CC00000001
1C0010010000001
100000001100101
101010000000001
1000000000000P1
11C0C0100001001
10000C011001101
10C0000000101C1
1100000000E0011
111111111111111
