111111
100101
10ECP1
111111
sda
asdas
asdasasd
dsasda