1111111
1EC0P01
1111111
sdd
asd
ss
