1 11111
1PC0001
100C001
10000E1
1111111
