111111111111111
1000010000F0001
1C0F00001000101
101011C000F0011
10000CC00000001
1C0010010000001
100000001100101
10101000000F001
1000000000000P1
11C0C0100001011
10000C011010011
10C0F00000100C1
1100000000E0001
111111111111111
