1111111111111111111111111111111111
11001E100000000C00000C000000000001
1010111100100000101001000000010101
1010010010101010001001000000010101
1C0000000C00C00000000000P0000000C1
1111111111111111111111111111111111