111111111111111111
100000P0001000C001
100000000000111111
1000000000C0000001
100000000000111111
111111000000000001
100000000C00000001
100001111000000001
1000000000000000E1
1000000C0000000001
100000000000000001
111111111111111111