111111
1P00F1
10C001
100001
10C0E1
111111