111111111111111
100001000000001
1C00M0001000101
101011C00000011
10000CC00000001
1C0010010000001
100M00001100101
1010100M0000001
10000000M0000P1
11C0C0100001001
10000C011001101
10C0000000101C1
1100000M00E0011
111111111111111
