1111111
1PC00M1
100C001
1M0P0E1
1111111
