1111111
1E00M01
1P00001
1000EC1
1111111
