1111111
1EC0PM1
1111111
sdd
asd
ss
