111111111111111
100001000000001
100000000G000P1
11C0C0100001011
10000C011010011
10C0000000100C1
110000M000E0001
111111111111111
