111111111111111111
100000P0001000CM01
100M00000000111111
1000000000C0000001
100000000000111111
11111100M000000001
100000000C000000M1
100001111000000001
10000000000000M0E1
1000000C0000000001
1000000M0000000001
111111111111111111