1111111111111
1M010000C0001
1000011111111
10P011E000001
1111111111111