11111111111111111111
1P000000000000000001
10000000000M00000001
10000000000000000001
1000000M000M00000001
100000000000000000E1
11111111111111111111
