1111111
10C0001
100C001
1M000E1
1111111