111111
1P0M01
10C001
100M01
10C0E1
111111