111111
1P0001
10C0M1
1M0MM1
10CME1
111111