111111
1P0001
10C0M1
1M0001
10C0E1
111111